0 LA010189-0001
1 LA010189-0002
2 LA010189-0003
3 LA010189-0004
4 LA010189-0005
